000000000000000000000
111111011101111111010
010001010101000001010
010111010101011101110
000100010101010000010
011101110111010111110
010001000000010100000
011101110111110111010
000100000100010001010
011101111101010111010
010001010001010100010
011101010111110111110
010101010100000000010
010101010111110111110
010101010000010100000
010111011101010101110
010000000101010100010
010111110101110111010
010100010100000001010
010111010101110111010
010001000101010100010
011101011101011101110
000101010101000001010
011101010101011111010
010001010001000001000
011101010111011101110
000101010100010100010
010101010101110101110
010101010100010101010
011111011111110111011
000000000000000000000