0000000000000000000000000000000
1111111101111111111111110111010
0100000101000001000000010101010
0111110101110101011101010101110
0100010000010101010101010100010
0101110111110101110101011101110
0101000100000100000101000001000
0101110111011111011101111101010
0000010001010000010000000101010
0111011111010111110111111101010
0101010000010100000101010001010
0101011111110101110101010111010
0100000000010101010001010100010
0101111111110111011101010101110
0100000000010000000101000101010
0101111111011101111101111101010
0101000001000101000001000001000
0101011101011101011101110111110
0101010101000001010100010000010
0101010101110111010111011111010
0101000100010100000001000001010
0101011101110111111101111101010
0101010001000000000101010101010
0101011101111101110101010101110
0101010100000101010100010000010
0111010101111101010101110111110
0000010101000001010101000100000
0111110111011111011101110101110
0100000000010100000001010101000
0111011111110101110111010101110
0001000001000101000100010100010
0101111101110101110111011101110
0100000100000100010001000001000
0111110111110111011101011111110
0001010000010001000101000000010
0111011111010111011101111111010
0100000001010100010100000001010
0101111111011101110111111101110
0100010000000000010100000000010
0111011111110111110101111111110
0101000000010101000101000000000
0101111111010101110101110111110
0100000001000100010000010000010
0111111101111111011111111111111
0000000000000000000000000000000